1111111111111111111111111111111
10000000000X0000000000000000001
1000111100111100111100111100001
1000000100X00100C001000C0100001
10P0000100011100011100001110001
1000000100C00100000100000100001
10000001001111X0111100000100001
1000C000000C0000000000000000E01
1111111111111111111111111111111