11111111111111111111111
10000000000110000000001
10001010000000000000001
10000000010000000000011
1000000000000PCE0000001
10001101000000000000011
10000000000000000000001
11111111111111111111111