11111111111111111111111
10000000000110000000001
100010100000C00000C0001
100000000100000000X0011
10X0000000000PCE0000001
100011010000C0000000011
1000000000X000000000001
11111111111111111111111