1111111111111
1P100010000C1
101010001X001
100011E001111
1111111111111
