1111111111111
110CCCCCCCCC1
11CC1111111C1
1PC0X1ECCCCC1
1111111111111