111X11111111111
1EPCCCCCCCCCCC1
111111111111111