111111111111111
1ECCCCCCCCCCCP1
1111X1111111111