111111111111111
111111111111111
111111111111111
11111X11CCC1111
1111111111C1111
111C111111C1111
1P00000C00000E1
111111111111111