1111111111111111111111111111111
1000000000000000000000000000001
1000111100111100111100111100001
1000000100000100C00100000100001
10P0000100011100011100001110001
1000000100000100000100000100001
1000000100111100111100000100001
1000000C00000000000000000000E01
1111111111111111111111111111111