11111111111111111111111
1000000000011C000000001
10001010000000000000001
10000C00010000C00000011
100000000C0000000E00001
10001101000000000000011
100P0000000000000C00001
11111111111111111111111