111111111111111111
1C00C00000000001P1
1000C00E0000000001
111111111111111111