11111111111111111111111
1000000000011C000000001
100P0010000000000000001
10000C00010000C00000001
100000000C0000000E00001
10001100000000000000011
10000000000000000000001
11111111111111111111111