111111111111111111
1E0000000000000011
10000C000P00000001
111111111111111111