111111111111111111
1P00000000E0000111
1100C00000C0000001
111111111111111111