111111111111111111
1P000000000E000011
1000C0000000000001
111111111111111111