111111111111111111111111111111
10000000000X000000000000000001
100011100011110011110011110001
1000101000X00100C0010010010001
10P000100001110001110000010001
100000100000010000010000010001
10000111001111X011110000010001
100000C00000000000000000000E01
111111111111111111111111111111