1111111111111111111111111111111111111111
1000000000011000000000000000000000000001
1000101000000000000000000000000000000001
1000000001000000000000000000000000000011
1000000000000PCE000000000000000000000001
1000110100000000000000000000000000000011
1000000000000000000000000000000000000001
1000000000000000000000X00000000000000001
1000000000000000000000000000000000000001
1000000000000000000000000000000000000001
1000000000000000000000X00000000000000001
1000000000000000000000000000000000000001
1000000000000C00000000000000000000000001
1000000000000000000000000000000000000001
1000000000000X00000000000000000000000001
1000000000000000000000000000000000000001
1000000000000000000000000000000000000001
1000000000000000000000000000000000000001
1000000000000000000000000000000000000001
1111111111111111111111111111111111111111